 390.  735.  846. 1031.  808.  660.  315.  144.   21.    0.
 416.  470.  583.  543.  558. 1047.  655.  381.  210.   87.
 413.  583.  742. 1095.  643.  560.  423.  290.  153.   48.
 403.  643. 1012. 1126.  650.  542.  280.  157.  124.   13.
 476.  504.  596.  673. 1095. 1069.  330.  143.   62.    2.
 468.  565.  708. 1020.  747.  521.  408.  330.  148.   35.
515. 916. 827. 989. 981. 518. 163.  41.   0.   0.
900. 890. 728. 588. 543. 480. 396. 262. 131.  32.
 487.  715.  977.  983. 1094.  544.  140.   10.    0.    0.
829. 787. 681. 623. 592. 448. 389. 285. 239.  77.
 637. 1244.  764.  320.  478.  704.  469.  302.   32.    0.
 824. 1300.  843.  720.  577.  350.  156.  111.   69.    0.
448. 566. 976. 810. 666. 597. 379. 259. 211.  38.
 423.  637.  772. 1041.  796.  553.  353.  237.  121.   17.
406. 656. 844. 989. 760. 625. 403. 221.  46.   0.
428. 537. 634. 584. 787. 932. 554. 301. 158.  35.
 541. 1142.  886.  726.  576.  462.  342.  181.   73.   21.
536. 865. 825. 790. 661. 521. 377. 261. 112.   2.
459. 818. 893. 886. 809. 552. 367. 151.  15.   0.
 558.  716. 1066.  687.  631.  474.  344.  243.  152.   79.
 430.  477.  444.  517.  591.  716. 1340.  435.    0.    0.
 458.  462.  452.  496.  576.  767. 1293.  446.    0.    0.
