477. 618. 705. 711. 793. 595. 441. 524.  86.   0.
787. 956. 827. 723. 550. 415. 334. 157. 120.  81.
816. 899. 752. 695. 523. 503. 331. 194. 142.  95.
887. 906. 762. 658. 557. 384. 329. 212. 160.  95.
889. 882. 703. 580. 503. 416. 393. 301. 193.  90.
964. 711. 627. 575. 501. 477. 305. 342. 338. 110.
2065. 1257.  353.    0.    0.    0.    0.  351.  398.  526.
2427.  192.    0.    0.    0.    0.    0.  155. 1366.  810.
479. 438. 446. 474. 549. 832. 593. 747. 392.   0.
 446.  715.  758. 1215. 1022.  583.  198.   13.    0.    0.
 537.  713.  712. 1217.  940.  634.  192.    5.    0.    0.
 477.  654.  777. 1182.  977.  614.  261.    8.    0.    0.
 456.  725.  797. 1265.  953.  562.  179.   13.    0.    0.
 451.  642.  759. 1145. 1052.  597.  275.   29.    0.    0.
 446.  744.  772. 1301.  965.  544.  171.    7.    0.    0.
 462.  688.  799. 1250.  952.  560.  219.   20.    0.    0.
 492.  602.  722. 1209.  985.  610.  323.    7.    0.    0.
4.930e+02 6.470e+02 7.090e+02 1.268e+03 9.780e+02 6.280e+02 2.260e+02
 1.000e+00 0.000e+00 0.000e+00
 450.  596.  660. 1122. 1050.  710.  351.   11.    0.    0.
 529.  588.  659. 1328.  942.  714.  188.    2.    0.    0.
 423.  652.  746. 1106. 1058.  634.  308.   23.    0.    0.
 512.  706.  793. 1140.  944.  599.  240.   16.    0.    0.
 491.  630.  688. 1258.  990.  679.  203.   11.    0.    0.
 448.  732.  784. 1182.  990.  559.  241.   14.    0.    0.
 466.  749.  794. 1210.  989.  561.  177.    4.    0.    0.
4.600e+02 7.040e+02 8.310e+02 1.242e+03 9.410e+02 5.930e+02 1.780e+02
 1.000e+00 0.000e+00 0.000e+00
 467.  655.  728. 1200. 1018.  591.  282.    9.    0.    0.
 454.  725.  855. 1255.  954.  489.  212.    6.    0.    0.
 499.  604.  665. 1221.  976.  702.  280.    3.    0.    0.
 452.  677.  749. 1084. 1026.  626.  310.   26.    0.    0.
 448.  674.  800. 1205.  990.  578.  246.    9.    0.    0.
 468.  683.  813. 1269.  936.  574.  203.    4.    0.    0.
 465.  634.  754. 1242.  949.  619.  283.    4.    0.    0.
 479.  719.  832. 1222.  924.  578.  193.    3.    0.    0.
 514.  660.  745. 1135.  957.  685.  246.    8.    0.    0.
 495.  577.  752. 1180.  985.  627.  318.   16.    0.    0.
 439.  700.  939. 1203.  948.  513.  191.   17.    0.    0.
 506.  650.  772. 1223.  954.  669.  176.    0.    0.    0.
 448.  619.  796. 1260.  918.  628.  275.    6.    0.    0.
 455.  604.  745. 1162. 1010.  601.  338.   35.    0.    0.
4.35e+02 7.51e+02 8.55e+02 1.27e+03 9.13e+02 5.40e+02 1.85e+02 1.00e+00
 0.00e+00 0.00e+00
 520.  646.  746. 1276. 1013.  602.  145.    2.    0.    0.
 405.  662.  643. 1030. 1197.  582.  307.  124.    0.    0.
 479.  688.  724. 1120. 1026.  602.  296.   15.    0.    0.
 449.  693.  744. 1188. 1001.  604.  263.    8.    0.    0.
 451.  602.  734. 1115. 1030.  637.  345.   36.    0.    0.
 446.  738.  780. 1266.  974.  518.  222.    6.    0.    0.
 514.  745.  747. 1211.  931.  567.  225.   10.    0.    0.
 476.  700.  781. 1243.  933.  597.  217.    3.    0.    0.
 469.  720.  764. 1234.  983.  574.  195.   11.    0.    0.
 436.  714.  781. 1120. 1077.  586.  216.   20.    0.    0.
 437.  661.  774. 1039. 1079.  635.  294.   31.    0.    0.
 432.  709.  752. 1084. 1101.  551.  271.   50.    0.    0.
471. 678. 715. 815. 717. 599. 431. 309. 167.  48.
 448.  688.  765. 1228.  983.  603.  228.    7.    0.    0.
 460.  564.  697.  880. 1077.  651.  414.  193.   14.    0.
571. 880. 633. 559. 474. 448. 472. 457. 429.  27.
