 340.  417.  389.  480.  503.  495.  593. 1302.  374.   57.
360. 886. 752. 675. 715. 829. 563. 170.   0.   0.
 417.  457.  485.  517.  595.  711. 1311.  457.    0.    0.
 441.  448.  508.  483.  585.  721. 1317.  447.    0.    0.
 441.  836. 1063.  766.  661.  476.  358.  210.  117.   22.
415. 940. 835. 708. 661. 533. 413. 253. 158.  34.
 484.  431.  439.  533.  553.  731. 1281.  498.    0.    0.
370. 886. 666. 640. 807. 837. 579. 165.   0.   0.
