423. 451. 507. 921. 918. 610. 486. 297. 304.  33.
445. 474. 538. 780. 630. 522. 477. 461. 621.   2.
409. 401. 584. 866. 917. 619. 420. 365. 315.  54.
 352.  418.  431.  454.  459.  494.  500. 1341.  400.  101.
356. 425. 395. 460. 474. 494. 987. 788. 442. 129.
 481.  528.  570.  632.  817. 1060.  759.  103.    0.    0.
 468.  515.  581.  659.  851. 1066.  687.  123.    0.    0.
496. 552. 616. 662. 941. 985. 623.  75.   0.   0.
 365.  419.  374.  457.  511.  498. 1018.  755.  417.  136.
 456.  566.  562.  643.  944. 1009.  690.   80.    0.    0.
 523.  560.  555.  773. 1087. 1051.  390.   11.    0.    0.
 456.  468.  563.  589.  575.  998. 1045.  254.    2.    0.
468. 555. 731. 810. 827. 984. 566.   9.   0.   0.
 740. 1018.  659.  576.  504.  510.  470.  316.  151.    6.
 512.  592. 1195.  761.  638.  495.  383.  368.    6.    0.
 524. 1015.  882.  776.  607.  391.  414.  244.   97.    0.
